                   #                    
                        ##              
                ######                  
                           ##           
     #                      ##          
      ##                   # #   #      
        #                  #  # ##      
         #  #             #    ##       
          ##              #             
               #         #              
            # ##                        
              # #       #               
          ##  # #      #                
        P     # #                       
             #        #                 
     #########      #                   
                                        
                                        
                                        
^^^^^^^^^^^^^^^^^^^^^^^^^^^^^^^^^^^^^^^^