                                        
                                        
                                        
                                        
          #                             
                #    #         #        
  #       #          ##     #           
  #       # #  ###        #             
  #  # #      ##                        
       #                      P         
 #   # #  #####  #             #        
#      #  #       #                     
     #    #                             
     # #  #     ##                      
 #     #          #                    #
     #    #                             
     #    #                             
#                                       
                                        
                                        