                              #####     
                                        
                        ####            
                    ###                 
      #          ###         #          
      #   # #    #                      
     P#  #########    #  # #            
                                        
    ######## ######## #                 
             #   #    #                 
     ##  #                              
              #                         
       # # #                            
                                        
  #                   ##                
  #                                     
  ##                                    
   # #         #########                
        #                #              
     ###  # #                   ########