                   #                    
                  ##     ##             
                                        
 #              ######     ##           
###  #                      ##          
# #   ##                   # #   #      
###     #                  #  # ##      
 ##      #  #             #    ##       
          ##              #             
               #         #              
            # ##         #              
              ##        #               
          ##  # #      #                
        P     # #                       
             #        #                 
     #########      #                   
                                        
                                        
                                        
^^^^^^^^^^^^^^^^^^^^^^^^^^^^^^^^^^^^^^^^