                                        
      P##                               
   # #                                  
   # ###                                
                                        
   #            #    #         #        
  #  #               ##     #           
  ##     #  #  ###        #             
  #  #   #    ##                        
   #     #                              
 #   #   ######  #           # #        
#  #     ##       #                     
     #   ##                             
   # #   ##     ##                      
 # #     #        #                    #
     #   ##                             
   # #   ##                             
#  #     #                              
                                        
         #                              