 #####                                  
 #####             P                    
 #####                             #    
 ####               #  #         # #    
     ### #### #  ####  #       # # #####
     #     #           #     # #       #
     #########        ##   # #        ##
                         # #          ##
                 #     # #            ##
                     # #              ##
                   # #                ##
                 # #                  ##
               # #                     #
                                       #
########################################
                                        
                                        
                                        
                                        
                                        