        #              #             ## 
        #                       #       
                                        
            # #                         
    #                  ###              
    #         #                         
   ##P ########        #                
    #             ##  #  #              
    ######  ###       #  #              
               # ###               # #  
  #              ## #     #        #    
            #    # # #                  
#           # # ##   #          #       
       ######   #               #       
                   #     #  #           
    #                                   
              #                        #
                    #                   
            #   #                #      
                           ##           