     P                                  
                                        
     #                                  
                                        
          #                             
                #    #         #        
  #       #          ##     #           
  #       # #  ###        #             
  #  #        ##                        
                                        
 #   #    #####  #           # #        
#         #       #                     
     #    #                             
     #    #     ##                      
 #                #                    #
     #    #                             
     #    #                             
#                                       
                                        
                                        