        #              #             ## 
        #                               
                                        
              #                         
    #                  ###              
    #         #                         
   ##P ########        #                
    #                 #  #              
    ######  ###       #  #              
                 ##                # #  
  #               # #     #        #    
                     #                  
#           # #  #   #          #       
       ######   #               #       
                         #  #           
    #                                   
              #                        #
                    #                   
            #   #                #      
                           ##           