                                        
                                        
                                        
                                        
          #                             
          #          #         #        
  #  P    #          ##     #           
  #       #                             
  #  # #  #                             
       #  #                             
 #   # #  #      #             #        
#      #  #       #                     
     #    #                             
     # #  #     ##                      
 #     #          #                     
     #    #                             
     #    #                             
#                                       
                                        
                                        