        #              #             ## 
        #    #                  #       
                                        
            # #          #              
    #                  ###  #           
    #         #     #                   
   ##P ########        #                
    #             ##  #  #              
    ######  ###       #  #    #         
               # ###   #        #  # #  
  #              ## #     #        #    
            #    # # #                  
#           # # ##   #          #       
       ######   #               #       
                   #     #  #           
    #                                   
              #                        #
                    #                   
            #   #                #      
                           ##           