     P                                  
                                        
   # #   #                              
   #     #                              
     #   ##                             
   #     #      #    #         #        
  #  #   ##          ##     #           
  ##     ## #  ###        #             
  #  #   #    ##                        
   #     #                              
 #   #   ######  #           # #        
#  #     ##       #                     
     #   ##                             
   # #   ##     ##                      
 # #     #        #                    #
     #   ##                             
   # #   ##                             
#  #     #                              
                                        
         #                              