 #####                                  
 #####             P   #                
 #####                 #           #    
 ####               #  #         # #    
     ### #### #  ####  #       # # #####
     #     #           #     # # ###    
     #########         #   # # ###      
                         # # ###        
                 #     # # ###          
                     # # ###            
                   # # ###  #           
                 # # ###                
                 # ### #                
                ####                    
#################                       
                                        
                                        
                                        
                                        
                                        