######                                  
######                                  
######                             #    
#####         ###   #  #         # #    
##       #####   ####  #       # # #####
##                     #     # #       #
##   ##########       ##   # #         #
#               ###      # #           #
#                      # #             #
#                    # #               #
#                  # #                 #
#                # #                   #
#              # #                     #
#P                                     #
########################################
                                        
                                        
                                        
                                        
                                        