               #                        
               #                        
               #                        
               #  #                     
     ### #### #####                     
     #     #   #  #                     
     ###########  ######                
               #P  #  ##                
               #####  #####             
                   #   #  #             
                   #####  #####         
                       #   #  #         
                       #####  #####     
                           #   #  #     
                           #####  ##    
                               #   #    
                               #####    
                                        
                                        
                                        