   #                          #####     
   #                                    
   #                    ####            
   #                ###                 
   #             ###         #          
   #  #   # #    #                      
   # P#  #########    #  # #            
   #                                    
   ######### ######## #                 
    #        #   #                      
     ##  #                              
              #                         
       # #                              
                                        
                      ##                
                                        
                                        
               #########                
                         #              
                                ########