               #                        
               #                        
               #                        
               #  #                     
     ### #### #####                     
     #  P  #   #  #                     
     ###########  ######                
               #   #  ##                
               #####  #####             
                   #   #  #             
                   #####  #####         
                       #   #  #         
                       #####  #####     
                           #   #  #     
                           #####  #     
                                        
                                        
                                        
                                        
                                        