        #              #             ## 
        #    #                  #       
                                        
           ## #    #  # ##              
   #      #      #    ####  #           
#             #  #  # # #    #          
    #P ########  #    ##                
    #             ##  #  #              
    ######  ####      #  #    #         
               # ###  ##        #  # #  
  #              ## # #   #        #    
           ##    # # #             #    
#           # # ##   #          ##      
       ###### # #             # #       
                   #     # ##           
    #                                   
              #            #           #
                    ##                  
            #   #                #      
                           ##  #        