######                                  
######             P                    
######                             #    
#####               #  #         # #    
##   ### ####    ####  #       # # #####
##   #     #           #     # #       #
##   ##########       ##   # #         #
#               ###      # #           #
#                      # #             #
#                    # #               #
#                  # #                 #
#                # #                   #
#              # #                     #
#                                      #
########################################
                                        
                                        
                                        
                                        
                                        