 #####                                  
 #####            #P#                   
 #####           #   #             #    
 ####             ###            # #    
     ### #### #                # # #####
     #     #                 # # ###    
     #########             # # ###      
                         # # ###        
                 #     # # ###          
                     # # ###            
                   # # ###  #           
                 # # ###                
                 # ### #                
                 ###                    
                                        
                                        
                                        
                                        
                                        
                                        