 #####                #                 
 #####             P  #                 
 #####                #            #    
 ####                 #          # #    
     ### #### #  ######        # # #####
     #     #                 # # ###    
     #########             # # ###      
                         # # ###        
                 #     # # ###          
                     # # ###            
                   # # ###  #           
                 # # ###                
                 # ### #                
                ####                    
#################                       
                                        
                                        
                                        
                                        
                                        