                #                       
    ##P#                                
       #                                
   ### ###                              
       #                                
   #  #         #    #         #        
  #  #               ##     #           
  ##     #  #  ###        #             
  #  #   #    ##                        
   #     #                              
 #   #   ######  #           # #        
#  #     ##       #                     
     #   ##                             
   # #   ##     ##                      
 # #     #        #                    #
     #   ##                             
   # #   ##                             
#  #     #                              
                                        
         #                              