 #####                                  
 #####             P                    
 #####                             #    
 ####               #  #         # #    
     ### #### #  ####  #       # # #####
     #     #           #     # # ###    
     #########        ##   # # ###      
                         # # ###        
                 #     # # ###          
                     # # ###            
                   # #      #           
                 # #                    
                 #                      
                                        
#################                       
                                        
                                        
                                        
                                        
                                        