                                        
                                        
                                        
                                        
          #                             
                #    #         #        
  #  P               ##     #           
  #       # #  ###                      
  #  # #      ##                        
       #                                
 #   # #  #####  #             #        
#      #  #       #                     
     #    #                             
     # #  #     ##                      
 #     #          #                    #
     #    #                             
     #    #                             
#                                       
                                        
                                        