        #              #             ## 
        #    #                  #       
                                        
           ## #    #    ##              
    #            #     ###  #           
#   #         #  #  #   #    #          
   ##P ########  #     #                
    #             ##  #  #              
    ######  ####      #  #    #         
               # ###   #        #  # #  
  #              ## # #   #        #    
            #    # # #                  
#           # # ##   #          #       
       ######   #             # #       
                   #     # ##           
    #                                   
              #            #           #
                    ##                  
            #   #                #      
                           ##           