 #####                                  
 #####             P                    
 #####                             #    
 ####               #            # #    
     ### #### #  ####          # # #####
     #     #                 # # ###    
     #########             # # ###      
                         # # ###        
                 #     # # ###          
                     # # ###            
                   # # ###  #           
                 # # ###                
                 # ### #                
                ####                    
#################                       
                                        
                                        
                                        
                                        
                                        