######                                  
######             P                    
######                             #    
#####         ###   #  #         # #    
##   ### #####   ####  #       # # #####
##   #                 #     # #       #
##   ##########       ##   # #         #
#               ###      # #           #
#                      # #             #
#                    # #               #
#                  # #                 #
#                # #                   #
#              # #                     #
#                                      #
########################################
                                        
                                        
                                        
                                        
                                        