######                                  
######                                  
######                             #    
#####         ###   #  #         # #    
##   ##  #####   ####  #       # # #####
##   #                 #     # #       #
##   ##########       ##   # #         #
#               ###      # #           #
#                      # #             #
#                    # #               #
#                  # #                 #
#                # #                   #
#              # #                     #
#P                                     #
########################################
                                        
                                        
                                        
                                        
                                        