        #              #             ## 
        #                       #       
                                        
              #                         
    #                  ###              
    #         #                         
   ##P ########        #                
    #             ##  #  #              
    ######  ###       #  #              
               # ##                # #  
  #               # #     #        #    
            #      # #                  
#           # # ##   #          #       
       ######   #               #       
                         #  #           
    #                                   
              #                        #
                    #                   
            #   #                #      
                           ##           