                   #                    
                  ###   ###             
                                        
                ######     ##           
     #                      ##          
      ##                   # #   #      
        #                  #  # ##      
         #  #             #    ##       
          ##              #             
               #         #              
            # ##                        
              # #       #               
          ##  # #      #                
        P     # #                       
             #        #                 
     #########      #                   
                                        
                                        
                                        
^^^^^^^^^^^^^^^^^^^^^^^^^^^^^^^^^^^^^^^^