                   #                    
  #               ##   ####             
  #                                     
  #             ######     ##           
     #                      ##          
      ##                   # #   #      
        #                  #  # ##      
         #  #             #    ##       
          ##              #             
               #         #              
            # ##                        
              ###   #   #               
          ##  # #   ## #                
        P     # #                       
             #        #                 
     #########      #                   
                                        
                                        
                                        
^^^^^^^^^^^^^^^^^^^^^^^^^^^^^^^^^^^^^^^^