     P                                  
                                        
   # #   #                              
         #                              
         ##                             
         #      #    #         #        
  #      ##          ##     #           
  #      ## #  ###        #             
  #  #   #    ##                        
         #                              
 #   #   ######  #           # #        
#        ##       #                     
     #   ##                             
     #   ##     ##                      
 #       #        #                    #
     #   ##                             
     #   ##                             
#        #                              
                                        
         #                              