##  ########### ##################    # 
#########    ######################## # 
###        # ##   #                ^#   
#           # #    #               ^#   
#             #                    #    
#         #   #  #               ###    
#             ###    #             #    
#    P        # #######  #   ####  #    
### ####    # ####                 #    
  #         # #  ############### # #    
  ##        # #  ##  # ## ###   #  #    
  #    ##   # #    #   # #   # ### ## # 
  #   #     # #     #               #   
  ##  #   # # ##   # ###    #      ##   
  #      #  # ##                    #   
###      #  # #               #   ###   
##### #########            #        #   
#     ##    ###########        ######   
#^###########  ##########  #   ##   ##  
            ###### #############        