                                        
                                        
                                        
       #                                
       #  #                             
       #        #    #         #        
  #  P #  #          ##     #           
  #    #  # #  ###        #             
  #  # #      ##                        
       #                                
 #   # #  #####  #           # #        
#      #  #       #                     
     #    #                             
     # #  #     ##                      
 #     #          #                    #
     #    #                             
     #    #                             
#                                       
                                        
                                        