                                        
                                        
                                        
                                        
          #                             
                     #         #        
  #  P               ##     #           
  #            ###                      
  #  # # ## # ##                        
       #                                
 #   # #  #####  #             #        
#      #  #       #                     
     #    #                             
     # #  #     ##                      
 #     #          #                     
     #    #                             
     #    #                             
#                                       
                                        
                                        