        #              #             ## 
        #    #                  #       
                                        
           ## #    #    ##              
    #            #     ###  #           
#   #         #     #   #    #          
   ##P ########        #                
    #             ##  #  #              
    ######  ###       #  #    #         
               # ###   #        #  # #  
  #              ## # #   #        #    
            #    # # #                  
#           # # ##   #          #       
       ######   #             # #       
                   #     #  #           
    #                                   
              #                        #
                    #                   
            #   #                #      
                           ##           