                   #                    
                  ##     ##             
                                        
                ######     ##           
     #                      ##          
      ##                   # #   #      
 #      #                  #  # ##      
         #  #             #    ##       
          ##              #             
               #         #              
            # ##         #              
              ##        #               
          ##  # #      #                
        P     # #                       
             #        #                 
     #########      #                   
                                        
                                        
                                        
^^^^^^^^^^^^^^^^^^^^^^^^^^^^^^^^^^^^^^^^