                   #                    
  #               ##   ####             
  #                                     
  #             ######     ##           
     #                      ##          
      ##                   # #   #      
        #                  #  # ##      
         #  #             #    ##       
#         ##              #             
#  #           #         #              
  ##        # ##                        
              ##        #               
          ##  # #      #                
        P     # #                       
             #        #                 
     #########      #                   
                                        
                                        
                                        
^^^^^^^^^^^^^^^^^^^^^^^^^^^^^^^^^^^^^^^^