   #                          #####     
   #                                    
   #                    ####            
   #                ###                 
   #             ###         #          
   #  #   # #    #                      
   # P#  #########    #  # #            
   #                                    
   ######### ######## #                 
    #        #   #    #                 
     ##  #                              
              #                         
       # #                              
                                        
  #                   ##                
  #                                     
  ##                                    
   # #         #########                
        #                #              
     ###  # #                   ########