 #####         #                        
 #####         #                        
 #####         #                        
 #####         #  #                     
     ### #### #####                     
     #  P  #   #  #                     
     ###########  ######                
               #   #  ##                
               #####  #####             
                   #   #  #             
                   #####  #####         
                       #   #  #         
                       #####  #####     
                           #   #  #     
                           #####  ##    
                               #   #    
                               #####    
                                        
                                        
                                        