######                                  
######             P                    
######                             #    
#####               #  #         # #    
##   ### #### #  ####  #       # # #####
##   #     #           #     # #       #
##   #########        ##   # #         #
#                        # #           #
#                      # #             #
#                    # #               #
#                  # #                 #
#                # #                   #
#              # #                     #
#                                      #
########################################
                                        
                                        
                                        
                                        
                                        