######                                  
######                                  
######                             #    
#####         ###   #  #         # #    
##     P #####   ####  #       # # #####
##         #           #     # #       #
##   ##########       ##   # #         #
#               ###      # #           #
#                      # #             #
#                    # #               #
#                  # #                 #
#                # #                   #
#              # #                     #
#                                      #
########################################
                                        
                                        
                                        
                                        
                                        