 #####                                  
 #####                                  
 #####                             #    
 ####                            # #    
     ### #### #                # # #####
     #  P  #                 # # ###    
     #########             # # ###      
                         # # ###        
                 #     # # ###          
                     # # ###            
                   # # ###  #           
                 # # ###                
                 # ### #                
                 ###                    
                                        
                                        
                                        
                                        
                                        
                                        