 #####                                  
 #####             P                    
 #####                             #    
 ####               #  #         # #    
     ### #### #  ####  #       # # #####
     #     #           #     # # ###    
     #########        ##   # # ###      
                         # # ###        
                 #     # # ###          
                     # # ###            
                   # # ###  #           
                 # # ###                
                 # ### #                
                                        
#################                       
                                        
                                        
                                        
                                        
                                        