                   #                    
  #               ##   ####             
  #                                     
  #             ######     ##           
     #                      ##          
      ##                   # #   #      
        #                  #  # ##      
 #       #  #             #    ##       
# #       ##              #             
## #           #         #              
 ###        # ##                        
              #######   #               
          ##  # #   ## #                
        P     # #                       
             #        #                 
     #########      #                   
                                        
                                        
                                        
^^^^^^^^^^^^^^^^^^^^^^^^^^^^^^^^^^^^^^^^