 #####                                  
 #####                                  
 #####                             #    
 ####                            # #P   
     ### #### #                # # #####
     #     #                 # # ###    
     #########             # # ###      
                         # # ###        
                 #     # # ###          
                     # # ###            
                   # # ###  #           
                 # # ###                
                 # ### #                
                 ###                    
                                        
                                        
                                        
                                        
                                        
                                        