        #              #             ## 
        #    #                  #       
                                        
           ## #    #  # ##              
          #      #    ####  #           
#             #  #  # # #    #          
     P ########  #    ##                
                # ##  #  #              
##########  ####   #  #  #    #         
               # ###  ##        #  # #  
  #              ## # #   #        #    
           ##    # # #             #    
#           # # ##   #          ##      
       ###### # #             # #       
                   #     # ##           
    #                                   
              #            #           #
                    ##                  
            #   #                #      
                           ##  #        