                #                       
    P  #                                
       #                                
  #########                             
                                        
                #    #         #        
          #          ##     #           
            #  ###        #             
              ##                        
   #                                    
 #   #   ######  #           # #        
#  #     ##       #                     
     #   ##                             
   # #   ##     ##                      
 # #     #        #                    #
     #   ##                             
   # #   ##                             
#  #     #                              
                                        
         #                              