                   #                    
                  ##     ##             
                                        
 #              ######     ##           
 #   #                      ##          
 #    ##                   # #   #      
 #      #                  #  # ##      
 ####    #  #             #    ##       
          ##              #             
               #         #              
            # ##                        
              ##        #               
          ##  # #      #                
        P     # #                       
             #        #                 
     #########      #                   
                                        
                                        
                                        
^^^^^^^^^^^^^^^^^^^^^^^^^^^^^^^^^^^^^^^^