                                        
                                        
                                        
                                        
          #                             
                     #         #        
  #  P               ##     #           
  #      #  #  ###                      
  #  # #      ##                        
       #                                
 #   # #  #####  #             #        
#      #  #       #                     
     #    #                             
     # #  #     ##                      
 #     #          #                     
     #    #                             
     #    #                             
#                                       
                                        
                                        