                   #                    
                  ##     ##             
 #                                      
 #              ######     ##           
 #   #                      ##          
#     ##                   # #   #      
#       #                  #  # ##      
 ##      #  #             #    ##       
          ##              #             
               #         #              
            # ##                        
              ##        #               
          ##  # #      #                
        P     # #                       
             #        #                 
     #########      #                   
                                        
                                        
                                        
^^^^^^^^^^^^^^^^^^^^^^^^^^^^^^^^^^^^^^^^