                   #                    
                  ##     ##             
                                        
                ######     ##           
     #                      ##          
   #  ##                   # #   #      
   #    #                  #  # ##      
   ##    #  #             #    ##       
    #     ##              #             
               #         #              
            # ##                        
              ##        #               
          ##  # #      #                
        P     # #                       
             #        #                 
     #########      #                   
                                        
                                        
                                        
^^^^^^^^^^^^^^^^^^^^^^^^^^^^^^^^^^^^^^^^