                   #       #            
                  ##     ##             
                                        
                ######     ##           
     #                      ##          
  #   ##                   # #   #      
        #                  #  # ##      
         #  #             #    ##       
          ##              #             
               #         #              
            # ##                        
              ##        #               
          ##  # #      #                
        P     # #                       
             #        #                 
     #########      #                   
                                        
                                        
                                        
^^^^^^^^^^^^^^^^^^^^^^^^^^^^^^^^^^^^^^^^