 #####                                  
 #####                                  
 #####                             #    
 ####                            # #    
     ### #### #                # # #####
     #  P  #                 # # ###    
     #########             # # ###      
                         # # ###        
                 #     # # ###          
                     # # ###            
                   # # ###  #           
                   # ###                
                   ### #                
                                        
                                        
                                        
                                        
                                        
                                        
                                        