                #                       
     #P#                                
     # #                                
  #########                             
                                        
                #    #         #        
                     ##     #           
            #  ###        #             
              ##                        
   #                                    
 #   #   ######  #           # #        
#  #     ##       #                     
     #   ##                             
   # #   ##     ##                      
 # #     #        #                    #
     #   ##                             
   # #   ##                             
#  #     #                              
                                        
         #                              