     P                                  
                                        
   # #   #                              
   #     #                              
     #   ##                             
   #     #      #    #         #        
  #  #   ##          ##     #           
  ##     ## #  ###        #             
  #  #   #    ##                        
   #     #                              
 #   #   ######  #           # #        
#  #     ##       #                     
     #   ##                             
   # #   ##     ##                      
 #       #        #                    #
     #   ##                             
     #   ##                             
#        #                              
                                        
         #                              