        #              #             ## 
        #    #                  #       
                                        
           ## #    #    ##              
   ##     #      #     ###  #           
#   #         #  #  #   #    #          
   ##P ########  #     #                
    #             ##  #  #              
    ######  ####      #  #    #         
               # ###   #        #  # #  
  #              ## # #   #        #    
           ##    # # #             #    
#           # # ##   #          ##      
       ###### # #             # #       
                   #     # ##           
    #                                   
              #            #           #
                    ##                  
            #   #                #      
                           ##  #        