                                        
                                        
                                        
                                        
          #                             
                     #         #        
  #  P               ##     #           
  #            #                        
  #  # # ## # ##                        
       #                                
 #   # #  #      #             #        
#      #  #       #                     
     #    #                             
     # #  #     ##                      
 #     #          #                     
     #    #                             
     #    #                             
#                                       
                                        
                                        