                   #                    
 #                ##     ##             
 #                                      
 #              ######     ##           
 #   #                      ##          
 ###  ##                   # #   #      
        #                  #  # ##      
         #  #             #    ##       
          ##              #             
               #         #              
            # ##                        
              ##        #               
          ##  # #      #                
        P     # #                       
             #        #                 
     #########      #                   
                                        
                                        
                                        
^^^^^^^^^^^^^^^^^^^^^^^^^^^^^^^^^^^^^^^^