 #####                                  
 #####           ##P##                  
 #####           ##  #             #    
 ####            #####           # #    
     ### #### #                # # #####
     #     #                 # # ###    
     #########             # # ###      
                         # # ###        
                 #     # # ###          
                     # # ###            
                   # # ###  #           
                 # # ###                
                 # ### #                
                 ###                    
                                        
                                        
                                        
                                        
                                        
                                        