 #####                                  
 #####             P                    
 #####                             #    
 ####               #  #         # #    
     ### #### #  ####  #       # # #####
     #     #           #     # #       #
     #########        ##   # #         #
                         # #           #
                 #     # #             #
                     # #               #
                   # #                 #
                 # #                   #
               # #                     #
                                       #
########################################
                                        
                                        
                                        
                                        
                                        