     P                                  
                                        
     #   #                              
         #                              
         ##                             
         #      #    #         #        
  #       #          ##     #           
  #      ## #  ###        #             
  #  #   #    ##                        
                                        
 #   #   ######  #           # #        
#        ##       #                     
     #   ##                             
     #   ##     ##                      
 #       #        #                    #
     #    #                             
     #   ##                             
#        #                              
         #                              
          #                             