 #####                                  
 #####                                  
 #####                             #    
 ####                            # #    
     ### #### #                # # #####
     #  P  #                 # # ###    
     #########             # # ###      
                         # # ###        
                 #       # ###          
                         ###            
                       ###  #           
                     ###                
                   ### #                
                                        
                                        
                                        
                                        
                                        
                                        
                                        