 #####                                  
 #####             P                    
 #####                             #    
 ####                  #         # #    
     ### #### #  ####  #       # # #####
     #     #           #     # # ###    
     #########        ##   # # ###      
                         # # ###        
                 #     # # ###          
                     # # ###            
                   # # ###  #           
                 # # ###                
                 # ### #                
                ####                    
#################                       
                                        
                                        
                                        
                                        
                                        