                   #                    
                  ##     ##             
 ##                                     
 ##             ######     ##           
  #  #                      ##          
 ##   ##                   # #   #      
 ##     #                  #  # ##      
# #      #  #             #    ##       
###       ##              #             
               #         #              
            # ##                        
              ##        #               
          ##  # #      #                
        P     # #                       
             #        #                 
     #########      #                   
                                        
                                        
                                        
^^^^^^^^^^^^^^^^^^^^^^^^^^^^^^^^^^^^^^^^