 #### ##################################
#                                      #
#                                      #
#                                      #
#                             P        #
                                       #
#                                  #####
#                                  #####
#                                  #    
#                                  #    
#                                       
#                                  #    
#                                  #    
#                       #####      #    
#                   ##             #    
#########                          #    
        #             #### ####   ##    
        #                          #    
        #            ###############    
        #     ########                  