########################################
#                                      #
#                                      #
#                                      #
#                                      #
#                                      #
#            #                     #####
#         ##                       #####
#        ##                        #    
#                                  #    
#                                  #    
#                                  #    
#     P                            #    
#                       #####      #    
#                   ##             #    
#########                          #    
        #             #### ####   ##    
        #                          #    
        #            ###############    
        #     ########                  