#




  P    #

  ##   #              #############
       #
       #                           #
  ######    #####     ###########  #
            #                      #
            #                      #
  ###  #####  ^^^ ##############   #
  #                                #
  #   ############                 #
  #                      ^^^^^^^^^^^
  #####                  ###########
                              ^^
########################################
