       #           #             ##     
                     #                  
     #               #                  
     #           #   #                  
     #  #           ##    #             
    #                                   
                                        
 #  #   #P          ##                  
         ##########                     
    ##   ### #  ###               #     
    ##    ##########   #  #             
            #       ####                
         ###### ##                    # 
                ## #                    
       #                     #          
     # #                   # #          
                                        
        #                               
      #                                 
         #                              