       #           #             ##     
                     #                  
     #               #                  
     #           #   #                  
     #  #           ##    #             
    #                                   
                                        
 #  #   #           ##                  
          #########                     
    ##   ### #  ###               #     
    ##      #     #       #             
                    ####                
          ##### ##                    # 
                #  #                    
       #                     #          
     # #                   # #          
                                        
        #                               
      #                                 
         #                              